##########
#*#****###
#*##*#*###
#****#*#*#
######*#*#
#********#
#*#*######
###*****##
#######**#
##########