##########
#*#****###
#*##*#*###
#****#*#*#
######*#*#
#********#
#*#*######
####****##
#######**#
##########